
1
11
111
1111
11111
111111
1111111
11111111
111111111
111111111